Plateau 24 40:
    0123456789012345678901234567890123456789
000 ........................................
001 ........................................
002 ....O...................................
003 ...OOOO.................................
004 ....OOOOO...............................
005 ........OOOOOO..........................
006 ...........OO...........................
007 ...........OO...........................
008 ............O...........................
009 ............O...........................
010 ............OOOOOOOO................XXX.
011 ..................O..................XXX
012 ..................OO..................XX
013 .................OOOOOO..........OO..XXX
014 ......................O..........OXXXX..
015 ......................OOOOO...OOOO....XX
016 ..........................O....OOO..XXXX
017 ...................OO.O.O.O.OOOOOOO.XXXX
018 ...................OO.OOOOOOOOOOOOO..X.X
019 ...................OOOOOOOOOOX..XXXXXX.X
020 ...................OOOOXXXXXOXXXXXXXXXXX
021 ....................O.OxX.XXXXXXXX..XXX.
022 ...................OOO.xXXXXXX.XXXXXXXXX
023 .......................xXXXXXXXXXXXXXXXX
Piece 1 4:
**..
